MyPacman maze 39x11
#######################################
#*************************************#
#+###*#####*#######*##ooo## #*###*###+#
#*****#*************#21 34# #*# #*****#
#####*#*###*###*### #     # #*###*#####
    #*#***#*# #*# # ####### #*#***#    
#####*#####*###*###    0    #*###*#####
#*******************#######***********#
#+###*######*#*####****#****#####*###+#
#************#*******#***#************#
#######################################