MyPacman maze 21x11
#####################
#+***#*********#***+#
#*##*#*#######*#*##*#
#*#***************#*#
#*#*##*##   ##*##*#*#
#******#42 13#******#
#*#*##*#######*##*#*#
#*#*******0*******#*#
#*##*#*#######*#*##*#
#+***#*********#***+#
#####################